NO ./textures/stone.xpm

		EA 		./textures/WALL74.xpm
    WE                ./textures/we_tex.xpm
  SO    ./textures/so_tex.xpm

C 0,0,255
F 55,,,200,120

111111111
110001001
110N00001
111111111